11111111
1P00CC01
11110111
11E00C01