11111111111111
1P000E000C0001
10000000000000