11111111111111
1P000000000101
1101C100C00E01
10011110000111
10C00000001111
1000111100C001
11111111111111