11111111111111
1P000000000001
1101C100C00001
10011100000001
100000000E1111
10001111010001
11111111111111
