11111111111111
1P000000000101
1101C100C00E01
10011110000111
10C00000001111
10001111000001
11111111111111