111111111111111111111
100000000C00000000001
100000000000000C00001
10C111000000001000001
100000000000P01000111
100000000011111000001
100011110000000000001
100000000011111000001
100011110000000000001
111111111111111111111