1111111
111C001
1111111
1111111
1111111