1111111111111111111111111
100000000C000000000000001
100000000000000C000000001
10C1110000000010000000001
100000000000P010001111111
1000000000111110000000001
1000111100000000000010001
1111111111111111111111111