11111111111111
1P0000000C0001
100000P0000001
10C11100000001
100000000E1111
10001111000001
11111111111111