1111111
1C0E0P1
1111111
1111111
1111111