11111111111111
1P0000000C0001
10000000000001
10C11100000001
10000000001111
10001111000001
11111111111111