111111111111111111111
1P0000000C00000000001
10000000000000C000011
10C111000000000100001
100000000000001000111
100000000011111000001
100011110000000000001
100000000011111000001
100011110000000000001
111111111111111111111